################################################################
#							       #
#							       #
#                                                              #
#                                                              #
#          						       #
# 							       #
#							       #
# 							       #
# 							       #
# 							       #
# 							       #
# 							       #
# 							       #
# 							       #
# 						               #
# 							       #
# 							       #
# 							       #
# 							       #
# 							       #
# 							       #
# 							       #
# 							       #
# 							       #
# 							       #
# 							       #
# 							       #
# 							       #
# 							       #
# 							       #
# 							       #
# 							       #
# 							       #
# 							       #
# 							       #
# 							       #
# 							       #
# 							       #								 
# 							       #
# 							       #
# 							       #
# 							       #
# 							       #
# 							       #
# 							       #
# 							       #
################################################################